9,9,9,9,9,9,9,9,9,9,9,9,9,9,9,9,9,9,9,9,9,9,9,9,9,9,9,9,9,9,9,9,9,9,9,9,9,9,9,9,9,9,9,9,9,9,9,9,9,9,9,9,9,9,9,9,9,9,9,9,9,9,9,9,9,9,9,9,9,9,9,9,9,9,9,9,9,9,9,9
9,0,0,2,0,0,0,0,3,0,0,3,0,0,0,3,0,0,0,0,0,2,3,0,3,0,0,0,0,0,0,0,0,3,0,0,0,0,3,0,0,3,0,0,0,0,0,0,0,0,0,0,0,0,0,0,0,2,0,0,2,2,3,0,0,0,0,0,0,0,0,3,0,0,3,0,0,2,2,9
9,0,0,0,0,0,0,0,0,0,0,2,2,0,0,0,0,0,3,0,3,0,2,0,0,0,3,0,3,0,3,2,0,0,0,0,0,0,3,0,0,2,0,3,0,0,0,3,0,0,0,3,2,3,0,0,0,0,0,0,0,0,0,0,0,0,0,0,2,0,0,0,2,3,0,0,0,0,0,9
9,0,0,3,0,0,0,0,0,0,0,0,0,3,0,2,0,0,0,0,0,0,0,0,0,0,3,0,0,2,3,0,0,0,3,3,2,0,0,0,0,0,3,2,0,0,3,3,0,0,2,2,0,0,0,3,3,2,0,0,0,3,2,0,0,0,3,0,0,2,0,2,2,0,0,2,0,0,0,9
9,3,0,0,0,2,2,0,0,2,0,0,3,0,0,2,0,2,0,3,2,0,3,0,0,2,0,0,0,0,3,3,3,0,0,3,0,2,0,3,2,0,2,0,2,0,3,0,2,0,0,0,0,3,0,0,0,2,0,3,3,0,3,0,0,0,0,0,3,0,0,0,0,0,3,2,0,3,3,9
9,0,0,2,2,3,0,0,0,3,0,3,0,0,0,0,2,3,0,0,0,0,0,3,3,0,0,2,0,0,3,0,2,0,3,0,2,2,0,0,3,0,2,2,0,0,0,0,3,0,0,3,3,0,2,0,0,2,3,0,0,3,2,2,3,2,0,2,0,0,2,0,3,0,0,0,0,2,0,9
9,0,0,2,0,2,3,0,0,0,0,0,0,0,2,0,2,0,2,0,0,0,0,3,0,2,0,0,0,0,0,2,0,0,0,0,0,3,0,0,0,0,0,2,0,0,0,0,3,0,0,2,2,0,0,0,2,0,0,0,0,0,3,0,2,2,2,0,2,0,0,0,3,3,0,0,0,0,0,9
9,2,0,0,2,0,0,0,3,0,2,0,3,3,0,0,0,0,3,0,3,0,0,0,0,0,2,0,0,0,3,0,0,0,2,3,0,0,0,0,0,0,3,0,0,0,2,0,0,0,0,0,0,0,2,2,2,0,0,0,0,0,0,0,0,2,0,0,0,0,0,0,0,3,0,3,0,3,0,9
9,2,0,0,2,2,0,3,0,3,0,0,0,0,0,3,3,2,2,0,3,0,0,0,0,0,0,0,0,0,0,0,0,0,0,0,0,0,3,2,0,2,0,0,0,3,0,0,0,0,0,0,0,0,3,2,0,0,0,2,0,3,3,0,0,3,0,0,2,2,3,0,0,0,0,0,2,0,0,9
9,2,0,0,2,0,2,0,0,0,0,0,0,0,2,0,0,0,0,0,2,3,0,3,0,3,0,2,0,2,0,0,0,2,0,2,0,0,0,0,3,2,3,3,0,0,3,0,0,3,0,2,0,0,0,0,3,3,2,0,0,0,2,2,0,0,0,0,0,0,0,0,0,2,0,0,0,0,0,9
9,0,0,3,0,0,0,0,3,0,3,0,0,0,2,2,0,0,2,0,0,0,0,0,0,0,0,0,0,0,0,2,0,0,0,2,0,0,0,3,3,2,0,3,2,0,0,0,0,0,2,0,2,0,3,3,0,0,0,0,0,0,0,0,0,0,2,0,3,0,0,3,0,0,0,0,0,0,0,9
9,0,3,0,0,0,0,0,0,0,0,3,0,0,0,0,0,2,2,0,0,3,0,2,0,0,0,0,0,0,0,3,2,0,0,0,0,0,0,2,0,0,0,2,0,0,0,2,0,0,2,0,0,3,0,0,0,0,0,0,0,0,0,0,2,0,0,3,2,2,3,0,2,0,0,0,2,3,2,9
9,0,0,2,0,3,3,0,0,0,0,2,0,0,0,0,3,3,0,0,3,0,3,0,3,0,0,0,0,0,0,2,0,0,0,0,0,3,0,0,2,0,2,0,0,0,2,2,3,0,0,3,0,0,0,0,0,0,2,0,3,0,2,2,0,0,0,3,0,0,0,2,0,3,0,2,0,0,0,9
9,0,0,0,0,2,0,0,0,0,3,0,0,2,0,0,2,0,0,2,0,2,0,0,0,3,2,0,0,2,0,0,0,0,2,2,2,0,0,0,0,0,0,2,0,0,0,3,2,0,0,2,2,2,0,0,0,0,0,0,0,0,0,0,0,0,0,0,0,3,0,2,0,0,0,0,2,0,0,9
9,0,0,2,0,2,0,3,3,0,0,0,2,2,0,0,2,0,0,2,0,0,0,0,2,3,0,3,0,0,3,0,3,0,0,2,0,0,0,3,0,0,0,0,0,0,0,0,0,3,0,0,0,2,0,3,3,0,3,0,0,0,2,3,0,0,0,0,0,2,3,0,0,0,2,2,0,0,3,9
9,0,3,2,0,2,3,0,0,0,3,0,0,0,3,0,0,2,3,0,0,0,0,2,2,3,0,0,0,0,3,0,0,0,0,0,0,0,0,0,0,0,0,3,0,2,3,0,0,3,0,2,2,0,0,2,0,3,0,0,0,0,2,0,0,2,2,0,0,0,0,0,3,2,0,0,2,0,3,9
9,0,0,0,0,0,0,3,0,0,0,3,2,0,2,2,0,0,3,3,0,0,0,0,0,0,3,0,2,3,2,2,3,0,3,2,0,2,0,0,0,3,0,3,0,0,0,0,0,0,0,0,3,0,0,0,0,0,0,0,3,3,0,0,0,0,0,2,0,0,3,0,0,3,0,0,2,0,0,9
9,0,0,0,0,0,0,0,0,0,0,0,3,0,3,2,0,2,0,0,0,0,0,3,0,2,0,2,0,3,0,0,2,0,0,0,0,2,3,0,0,2,0,2,0,0,0,0,3,2,0,2,3,0,0,3,0,2,0,0,0,3,0,3,0,0,0,0,2,0,0,0,2,0,3,0,0,3,0,9
9,0,3,2,0,0,0,0,2,0,0,0,0,0,0,2,0,2,0,0,0,2,0,0,0,0,0,0,0,0,0,2,2,2,0,2,0,3,0,0,3,0,0,0,0,0,2,0,0,0,2,0,0,2,0,0,3,0,0,0,0,3,2,0,0,0,2,0,0,0,0,0,0,3,0,0,0,0,0,9
9,0,0,2,0,2,0,0,2,0,0,0,0,2,0,0,0,3,3,2,2,0,0,0,0,0,0,2,0,3,0,0,0,2,0,0,3,3,0,0,2,0,0,0,0,0,3,3,0,0,0,0,0,0,0,2,0,3,0,0,3,0,0,0,0,3,0,0,0,0,0,0,2,0,0,0,0,0,0,9
9,0,0,0,2,3,0,0,2,0,0,3,0,0,0,2,0,3,0,0,0,0,3,3,0,0,0,0,0,0,0,0,0,0,0,0,2,0,3,2,0,0,3,0,2,3,0,2,0,0,0,0,0,0,0,3,0,3,0,0,0,0,3,0,0,3,2,0,0,2,0,3,0,2,0,0,0,0,0,9
9,0,0,0,0,2,0,3,0,0,0,3,0,2,0,0,3,0,3,2,3,0,0,0,0,3,0,0,0,0,0,0,0,0,0,0,0,0,0,0,2,2,0,0,0,0,0,0,0,3,0,2,2,0,0,0,0,0,2,3,0,0,0,0,0,3,0,0,2,2,2,0,3,0,0,0,0,0,0,9
9,3,3,2,2,0,0,0,2,0,0,3,2,0,0,0,0,3,3,0,0,0,2,0,0,0,0,0,3,3,3,0,0,3,0,2,0,0,0,2,0,0,3,0,0,2,0,0,0,2,0,0,0,0,0,0,2,2,0,0,3,0,0,0,3,0,0,0,0,0,0,0,3,0,2,0,2,0,0,9
9,0,0,0,2,0,0,0,0,0,2,0,3,0,0,0,0,2,0,0,0,0,0,3,0,0,0,0,0,3,0,3,0,0,0,3,0,0,0,2,0,0,0,0,0,0,3,0,0,0,2,0,0,0,0,0,0,0,0,0,0,2,0,2,0,0,3,3,0,0,3,0,0,0,3,0,0,2,0,9
9,0,0,2,0,2,0,0,0,2,0,2,0,2,0,0,0,2,2,3,0,0,0,0,0,0,0,0,0,3,2,0,2,0,0,0,2,3,0,3,0,0,2,0,2,0,0,2,0,3,2,0,0,0,0,0,0,0,0,0,3,0,0,0,2,0,0,0,0,0,0,0,0,3,3,3,0,3,0,9
9,0,2,2,2,3,0,0,2,0,0,0,3,2,0,0,0,0,0,2,0,2,0,0,2,2,0,0,2,2,2,0,0,0,0,2,3,0,0,0,2,0,3,0,0,0,0,0,0,0,0,0,2,0,0,3,2,0,0,0,2,0,3,0,0,0,2,0,0,3,2,0,0,3,0,0,2,0,3,9
9,0,3,0,0,0,3,2,3,0,3,0,0,0,0,3,0,0,0,0,0,0,3,0,0,0,0,3,0,0,0,0,0,0,0,2,0,0,0,0,0,0,0,3,2,0,0,0,0,0,3,0,0,2,0,0,0,0,0,3,3,0,0,0,0,0,0,0,0,0,0,0,0,2,0,0,2,0,0,9
9,0,0,0,0,3,0,0,0,0,0,0,0,2,0,0,3,0,0,0,0,2,0,0,3,0,0,0,0,0,0,0,0,0,0,0,0,2,0,0,0,0,0,0,3,0,2,0,2,0,0,0,3,2,3,0,0,0,0,0,0,0,0,3,0,0,0,0,0,3,0,0,2,0,0,0,0,3,0,9
9,3,0,0,2,2,3,0,0,0,3,0,0,0,0,0,0,0,0,0,2,0,0,0,2,3,2,3,0,3,0,0,2,0,2,3,3,0,0,3,0,0,3,0,0,2,0,0,2,2,0,3,0,0,0,0,0,0,3,0,0,0,0,0,0,0,0,2,2,0,0,0,2,0,0,0,0,0,0,9
9,3,0,0,0,2,0,0,0,0,2,0,0,2,0,2,3,0,0,0,0,0,0,2,2,2,2,0,0,0,0,0,0,2,2,0,2,0,0,0,2,3,0,3,2,0,0,0,0,0,2,0,0,0,0,3,0,0,2,0,0,2,0,2,0,0,0,0,0,0,0,0,0,2,2,0,0,0,2,9
9,2,2,0,3,2,3,0,2,3,0,3,0,2,0,3,0,0,0,0,0,0,0,0,0,0,0,3,0,0,2,0,3,0,0,0,0,3,0,0,2,0,0,0,0,0,0,0,0,0,0,0,3,0,3,3,0,2,0,0,2,3,0,0,0,0,0,2,0,0,0,3,0,0,0,0,0,0,2,9
9,2,3,0,0,0,0,0,2,0,0,0,0,3,0,0,0,0,0,0,0,0,0,0,0,0,0,2,0,2,0,0,2,3,0,2,0,0,0,0,0,2,2,0,0,0,0,0,0,0,3,2,0,2,3,0,0,3,2,0,0,0,0,0,0,0,0,0,0,0,0,3,3,2,3,0,2,0,0,9
9,0,0,0,3,0,0,0,3,0,3,0,3,0,0,0,0,0,2,2,0,0,0,0,0,0,3,2,0,2,2,0,2,0,0,0,3,0,0,3,3,0,2,3,2,0,0,3,3,0,0,2,0,0,2,0,0,3,2,0,0,2,2,3,0,0,0,0,0,3,0,0,0,0,0,0,0,3,0,9
9,2,0,0,0,0,0,3,0,2,3,2,0,2,0,2,0,2,3,0,0,0,0,0,0,0,0,0,3,0,0,0,0,0,0,3,0,0,0,0,2,2,0,2,0,0,0,3,0,2,0,2,0,0,0,2,2,3,0,0,0,3,0,3,3,0,0,0,0,0,3,3,0,0,0,2,2,3,0,9
9,0,2,0,2,0,3,0,3,3,0,0,0,0,0,2,0,3,0,0,0,0,2,3,0,3,2,0,0,0,0,0,0,0,2,0,0,2,0,0,3,0,0,2,0,0,2,3,2,0,0,0,2,2,0,0,3,0,0,0,0,2,2,0,0,0,2,2,0,0,3,0,0,0,3,3,2,3,0,9
9,2,0,3,0,0,3,0,0,2,0,0,0,0,0,0,0,3,0,0,2,0,3,0,3,0,0,0,0,0,2,3,0,0,0,0,2,0,0,0,3,0,3,0,0,3,0,3,0,0,0,0,0,0,0,0,0,0,0,0,0,0,0,0,0,0,2,0,0,0,3,0,0,2,0,0,0,3,3,9
9,0,3,0,0,0,3,2,2,0,0,0,0,0,2,0,3,0,0,0,0,0,0,0,2,3,0,2,0,3,0,0,0,2,0,3,0,3,0,0,3,0,0,0,0,0,0,0,0,0,0,0,0,0,0,2,0,3,3,2,0,0,0,2,0,0,0,0,0,0,0,0,0,0,0,0,2,0,2,9
9,0,0,0,0,0,0,0,0,0,0,3,0,0,0,0,0,0,0,0,0,2,0,0,2,0,0,3,0,0,0,0,0,3,0,0,0,2,3,0,3,0,0,3,0,0,3,0,2,0,0,0,0,0,3,0,0,0,0,2,0,3,0,0,2,0,3,0,0,0,3,0,3,0,0,0,0,3,3,9
9,0,0,0,3,3,0,0,0,0,0,0,2,0,0,3,0,0,3,3,3,0,3,0,0,2,0,0,3,0,0,0,0,0,0,0,0,0,0,3,3,3,0,0,0,0,0,0,2,2,0,0,0,2,0,0,2,0,2,0,0,2,0,2,0,2,0,3,0,0,0,2,0,2,0,2,0,3,0,9
9,0,0,0,3,3,2,3,0,0,2,0,0,0,0,0,0,0,0,0,0,2,0,0,0,0,0,0,0,2,0,0,0,3,2,0,0,0,0,0,0,2,0,0,3,0,2,3,0,0,0,3,3,0,0,0,0,0,0,3,0,0,0,0,2,0,0,2,0,0,0,0,3,0,0,2,3,0,3,9
9,0,0,0,0,3,2,2,0,3,0,0,0,0,3,0,3,0,0,0,3,0,3,0,0,0,0,3,3,0,3,0,0,0,2,0,0,0,0,0,3,0,0,3,2,2,2,0,0,0,0,3,0,0,0,0,0,0,0,0,0,0,0,2,2,0,3,0,0,0,0,0,0,3,0,0,0,0,0,9
9,0,0,2,2,0,0,0,0,2,0,0,0,2,0,0,0,0,0,3,0,0,0,3,0,2,3,0,0,0,2,3,0,0,3,0,0,0,0,0,0,2,2,0,0,0,0,0,2,0,0,0,2,0,3,0,2,0,3,0,0,2,2,0,0,0,3,0,2,0,2,0,2,0,2,0,2,0,0,9
9,0,0,0,3,0,0,0,0,0,0,0,0,0,0,0,0,0,3,3,2,0,0,2,0,0,0,3,3,0,0,0,0,3,0,0,0,0,0,0,2,2,0,0,0,0,2,0,0,0,3,0,2,3,0,0,0,0,0,0,0,3,0,0,0,0,0,2,3,0,2,3,0,0,0,0,0,0,3,9
9,0,2,3,0,3,0,2,2,0,0,0,0,0,2,0,0,0,0,2,2,0,0,2,0,0,0,0,3,0,3,3,0,0,0,0,3,0,2,0,0,0,0,0,0,0,0,3,0,0,0,2,0,0,0,0,0,0,0,0,0,0,0,0,0,0,0,0,0,0,2,0,0,2,2,0,0,0,0,9
9,2,0,0,2,0,3,0,0,0,0,2,0,3,0,0,0,0,0,0,0,0,3,2,0,0,0,3,0,2,2,3,0,0,0,2,0,0,0,0,2,3,0,0,0,0,2,3,0,0,0,2,2,0,0,3,0,0,3,2,0,0,0,0,0,0,0,0,0,0,2,3,3,3,0,2,0,3,2,9
9,0,0,0,0,3,0,0,0,0,0,0,0,3,3,0,2,0,2,3,0,0,0,0,2,2,3,0,0,0,2,3,0,3,0,0,0,0,3,0,0,0,0,3,0,3,3,0,2,2,0,3,0,3,0,3,0,3,0,0,0,0,3,0,0,2,0,0,0,0,0,3,0,0,0,0,2,3,0,9
9,0,0,0,3,0,0,2,3,0,3,0,0,0,3,0,0,0,2,3,0,0,0,3,0,0,0,0,0,3,0,0,0,0,3,3,0,0,3,0,0,0,3,0,0,0,0,3,0,0,3,0,3,0,3,3,0,2,3,0,0,0,0,0,0,0,0,0,0,0,3,0,3,0,0,0,2,0,0,9
9,0,0,0,3,0,2,0,0,0,0,3,2,0,0,0,0,0,2,0,0,3,3,2,0,0,0,0,2,0,0,0,0,0,0,0,0,0,0,2,0,2,0,2,3,0,0,0,2,0,0,0,0,3,0,2,0,0,2,0,0,3,0,0,2,0,0,0,0,0,0,3,0,0,0,0,0,3,3,9
9,0,0,0,0,2,0,2,2,0,0,0,2,0,2,0,2,0,0,0,0,3,0,3,3,0,3,0,0,0,0,0,0,0,0,0,0,2,0,0,0,0,0,3,0,0,3,0,2,2,0,0,0,0,0,0,0,2,3,0,3,0,3,0,0,0,2,0,3,0,0,0,2,0,0,0,2,3,0,9
9,0,0,3,0,2,0,0,3,2,0,0,3,3,0,2,0,0,2,0,0,0,0,0,0,0,3,3,0,0,3,0,0,0,0,3,3,0,0,0,3,0,0,0,2,3,0,2,0,0,0,0,2,0,2,0,0,2,0,3,0,0,0,0,0,2,0,0,3,3,0,3,2,2,0,0,0,2,2,9
9,2,0,2,0,0,0,0,0,0,3,0,0,0,0,0,0,0,0,0,0,0,0,2,0,0,3,0,0,0,0,0,0,2,0,0,3,2,2,0,3,0,2,3,0,0,0,3,0,0,0,0,0,0,0,3,0,0,3,0,0,0,0,0,3,2,0,0,0,0,0,3,0,0,3,0,0,3,0,9
9,0,0,0,0,0,0,3,0,2,0,0,0,0,2,0,3,3,0,0,3,0,0,2,0,0,0,0,0,0,0,3,0,0,3,0,0,0,0,0,3,0,2,0,3,3,0,0,0,0,2,0,0,0,0,0,3,0,0,3,0,0,0,0,2,0,0,3,0,0,0,2,0,2,2,0,3,0,3,9
9,0,0,0,0,3,0,0,0,2,3,0,0,2,0,0,0,3,0,0,0,0,0,0,0,0,0,0,0,0,3,0,2,3,0,3,2,0,0,0,0,2,0,0,0,0,2,0,3,0,2,3,2,2,0,0,0,3,0,0,0,0,0,0,0,3,0,0,3,0,0,0,0,0,0,0,0,0,0,9
9,2,0,2,0,0,2,0,2,3,3,0,0,0,3,0,0,0,0,2,0,3,3,0,0,0,0,0,0,0,0,3,3,2,3,2,0,0,0,3,3,0,2,0,3,0,0,0,0,0,0,0,0,2,0,3,2,0,2,2,0,0,3,0,0,0,2,0,2,0,0,0,3,0,3,0,0,3,3,9
9,0,0,0,0,2,0,0,0,0,0,2,3,0,0,0,0,0,2,0,0,0,0,0,0,0,3,2,0,3,0,0,2,3,0,0,0,0,0,2,3,0,0,3,0,2,0,0,0,3,0,0,0,0,0,2,0,0,0,0,0,3,0,0,0,3,0,2,2,0,2,0,0,0,0,2,0,0,0,9
9,0,0,0,0,0,0,3,2,2,0,2,3,0,2,0,0,3,0,2,3,0,3,0,0,0,0,0,2,0,0,0,0,0,0,0,3,2,3,2,0,0,3,0,3,0,0,0,0,0,0,2,0,0,0,0,0,0,0,0,0,0,3,0,0,0,0,0,2,0,3,2,2,0,0,0,2,0,0,9
9,0,3,2,0,0,0,2,0,0,2,0,0,0,0,0,3,0,0,3,0,0,2,0,0,0,0,0,0,0,2,0,3,0,0,0,0,0,3,0,0,0,3,3,0,0,3,0,3,0,0,0,3,0,0,0,0,0,0,0,0,0,0,0,3,0,0,0,0,0,2,3,3,3,3,0,0,0,0,9
9,3,0,0,0,0,0,3,2,3,0,0,0,2,0,0,0,0,0,0,0,0,0,3,0,3,0,3,0,0,2,0,0,0,0,0,0,0,0,0,2,0,0,0,0,0,0,0,0,0,0,0,0,0,0,0,0,0,2,0,2,0,0,0,0,3,0,0,0,0,0,0,0,0,0,2,0,3,0,9
9,3,0,0,3,0,2,3,0,0,0,0,0,0,2,0,0,0,2,0,0,0,0,0,0,0,2,0,0,0,0,0,0,0,3,0,0,0,3,0,0,2,0,3,0,2,0,0,0,0,3,0,0,0,0,0,3,0,2,0,0,0,2,0,0,0,0,3,3,2,3,0,2,3,3,2,0,0,3,9
9,9,9,9,9,9,9,9,9,9,9,9,9,9,9,9,9,9,9,9,9,9,9,9,9,9,9,9,9,9,9,9,9,9,9,9,9,9,9,9,9,9,9,9,9,9,9,9,9,9,9,9,9,9,9,9,9,9,9,9,9,9,9,9,9,9,9,9,9,9,9,9,9,9,9,9,9,9,9,9
